####################################################################################################
## ########                                             ############################################
## ########################### ######################## ############################################
## ########################### ######################## ############################################
## ########################### ######################## ############################################
## ##                          ######################## ##########                                 G
## ## ########## #######       ######################## ########## ############# ########          #
## ## ########## #######  #### ######################## ########## ############# ########          #
# ## ########## #######  #### ######################## ##########  ############ ###      ###########
##    ########## #######  ###         ################# ########## ############# ### ####       # ##
################ ############# ###### ################# ########## ############# ### ###        # ##
################ ############# ###### ################# ########## #      #       ## #### ##    # ##
###              ############# ###### ################# ##########                                ##
### ############ ############# ###### ################# ########## ############# ###              ##
### ######## ### ############# ######                                                             ##
### ######## ### ############# ################################### #############  ####### #### #  ##
### ######## ### ############# ################################### #############  ####### #### #  ##
###          ### ######                                   ######## #############  ####### #### #  ##
############ ### ############# ###### #####         #             ##############  ####### #### #  ##
#            ### ############# ###### ###### ###################################  ####### #### #  ##
#            ###                      ###### ########################   ########  ####### #### #  ##
I                    ######### ############# ########################   ########                  ##
#  # #       #  ############## ############# ########################   ########                  ##
#  # #                                                                                            ##
####################################################################################################