####################################################################################################
## ########                                             ############################################
## ########################### ######################## ############################################
## ########################### ######################## ############################################
## ########################### ######################## ############################################
## ##                          ######################## ########################                   G
## ## ########## ###################################### ######################## ################# #
## ## ########## ###################################### ######################## ################  #
## ## ########## ###################################### ######################## ###            # ##
##    ########## ############         ################# ######################## ### ########## # ##
################ #################### ################# ######################## ### ###     ## # ##
################ #################### ################# ######################## ### ####### ## # ##
###              #################### ################# ######################## ###         ## # ##
### ############ #################### ################# ######################## ############## # ##
### ######## ### ####################                                                           # ##
### ######## ### ############################################################### ################ ##
### ######## ### ############################################################### ################ ##
###          ### ######                                   ###################### ################ ##
############ ### #################### ########################################## ################ ##
############ ### #################### ########################################## ################ ##
############ ###                      ########################################## ################ ##
I            ###################################################################                  ##
############ #################################################################################### ##
############                                                                                      ##
####################################################################################################